111111
11P001
100111
100EC1
111111
