1111111111111111111111111111111
11P0N00000100000C000000000E0011
1N00C00000N10000C00CN0000000011
1000000C00000000C000000N0000011
1111111111111111111111111111111
