11111111111111111111111
1P00000C000C0N000CE0CN1
11111111111111111111111
